W W W W W W W W
W E E E E E E W
W E B E E H E W
W E E E B E E W
W E E E W E E W
W E E T E E E W
W E E E E T E W
W W W W W W W W
